19
15 12
###############
#..<<<..>>>..E#
#.###########v#
#.#..#...>>..v#
#.#..#.....<<<#
#.#...........#
#.#...........#
#..^.####.v.^.#
#..^.<<<<.v.^.#
#..^.####.v.^.#
#C.^.#..<<<...#
###############